
NO textures/walls/wallN.xpm
SO textures/walls/wallS.xpm

EA textures/walls/wallE.xpm
WE textures/walls/wallW.xpm

C 155,100,160
F 111,111,111
111111
101111
1 1111
111111
111111
1N1111
111111
