
NO textures/walls/wallN.xpm
SO textures/walls/wallS.xpm

EA textures/walls/wallE.xpm
WE textures/walls/wallW.xpm

C 155,100,160
F 111,111,111
1111111
10 1111
11 1111
1111111
1111111
11N1111
1111111
